WWWWWWWWWWWWWWWWWWWWWWWWWWWWWWWWWWWWWWWW                    
WWWWWWWWWWWWWWWWWWWWWWWWWWWWWWWWWWWWWWWW                    
WWWWWWWWWWWWWWWWWWWWWWWWW WWWWWWWWWWWWWW                    
WWWWWWWWWWWWWWWWWWWWWWWW   WWWWWWWWWWWWW                    
WWWWWWWWWW WW WW    WWWWW WWWWWWWWWWWWWW                    
WWWWWWWWWW WW WW   WWWWWW WWWWWWWWWWWWWW                    
WWWWWWWWWWW  WWW WWWWWWWW WWWWWWWWWWWWWW                    
WWWWWWWWWWWWWWWWWWWWWWWWWWWWWWWWWWWWWWWW                    
WWWWWWWWWWWWWWWWWWWWWWWWWWWWWWWWWWWWWWWW                    
WWWWWWWWWWWWWWWWWWWWWWWWWWWWWWWWWWWWWWWW                    
WWWWWWWWWWWWWWWWWWWWWWWWWWWWWWWWWWWWWWWW                    
WWWWWWWWWWWWWWWWWWWWWWWWWWWWWWWWWWWWWWWW                    
WWWWWWWWWWWWWWWWWWWWWWWWWWWWWWWWWWWWWWWW                    
WWWWWWWWWWWWWWWWWWWWWWWWWWWWWWWWWWWWWWWW                    
PWWWWWWWWWWWWWWWWWWWWWWWWWWWWWWWWWWWWWWW                    
WWWWWWWWWWWWWWWWWWWWWWWWWWWWWWWWWWWWWWWW                    
WWWWWWWWWWWWWWWHWWWWWWWWWWWWWWWWWWWWWWWW                    
WWWWWWWWWWWWWWWWWWWWWWWWWWWWWWWWWWWWWWWW                    
WWWW    WW WW   WW    WWWWWWWWWWWWWWWWWW                    
WWWW WWWWW WW WW W  WWWWWWWWWWWWWWWWWWWW                    
WWWWWWW WW WW WW W   WWWWWWWWWWWWWWWWWWW                    
WWWW    WW WW   WW    WWWWWWWWWWWWWWWWWW                    
WWWWWWWWWWWWWWWWWWWWWWWWWWWWWWWWWWWWWWWW                    
WWWW WWWWWWWWWWWWWWWWWWWWWWWWWWWWWWWWWWW                    
WWW              WWWWWWWWWWWWWWWWWWWWWWW                    
WWWW WWWWWWWWWWWWWWWWWWWWWWWWWWWWWWWWWWW                    
WWWWWWWWWWWWWWWWWWWWWWWWWWWWWWWWWWWWWWWW                    
WWWWWWWWWWWWWWWWWWWWWWWWWWWWWWWWWWWWWWWW                    
WWWWWWWWWWWWWWWWWWWWWWWWWWWWWWWWWWWWWWWW                    
WWWWWWWWWWWWWWWWWWWWWWWWWWWWWWWWWWWWWWWW                    
WWWWWWWWWWWWWWWWWWWWWWWWWWWWWWWWWWWWWWWW                    
WWWWWWWWWWWWWWWWWWWWWWWWWWWWWWWWWWWWWWWW                    
WWWWWWWWWWWWWWWWWWWWWWWWWWWWWWWWWWWWWWWW                    
WWWWWWWWWWWWWWWWWWWWWWWWWWWWWWWWWWWWWWWW                    
WWWWWWWWWWWWWWWWWWWWWWWWWWWWWWWWWWWWWWWW                    
WWWWWWWWWWWWWWWWWWWWWWWWWWWWWWWWWWWWWWWW                    
WWWWWWWWWWWWWWWWWWWWWWWWWWWWWWWWWWWWWWWW                    
WWWWWWWWWWWWWWWWWWWWWWWWWWWWWWWWWWWWWWWW                    
WWWWWWWWWWWWWWWWWWWWWWWWWWWWWWWWWWWWWWWW                  WW
WWWWWWWWWWWWWWWWWWWWWWWWWWWWWWWWWWWWWWWW                  WW
