WWWWWWWWWWWWWWWWWWWWWWWWWWWWWWWWWWWWWWWW                    
WWWWWWWWWWWWWWWWWWWWWWWWWWWWWWWWWWWWWWWW                    
WWWWWWWWWWWWWWWWWWWWWWWWWWWWWWWWWWWWWWWW                    
WWWWWWWWWWWWWWWWWWWWWWWWWWWWWWWWWWWWWWWW                    
WWWWWWWWWWWWWWWWWWWWWWWWWWWWWWWWWWWWWWWW                    
WWWWWWWWWWWWWWWWWWWWWWWWWWWWWWWWWWWWWWWW                    
WWWWWWWWWWWWWWWWWWWWWWWWWWWWWWWWWWWWWWWW                    
WWWWWWWWWWWWWWWWWWWWWWWWWWWWWWWWWWWWWWWW                    
WWWWWWWWWWWWWWWWWWWWWWWWWWWWWWWWWWWWWWWW                    
WWWWWWWWWWWWWWWWWWWWWWWWWWWWWWWWWWWWWWWW                    
WWWWWWWWWWWWWWWWWWWWWWWWWWWWWWWWWWWWWWWW                    
WWWWWWWWWWWWWWWWWWWWWWWWWWWWWWWWWWWWWWWW                    
WWWWWWWWWWWWWWWPWWWWWWWWWWWWWWWWWWWWWWWW                    
WWWWWWWWWWWWWWWWWWWWWWWWWWWWWWWWWWWWWWWW                    
WWWWWWWWWWWWWWWWWWWWWWWWWWWWWWWWWWWWWWWW                    
WWWWWWWWWWWWWWWWWWWWWWWWWWWWWWWWWWWWWWWW                    
WWWWWWWWWWWWWWWHWWWWWWWWWWWWWWWWWWWWWWWW                    
WWWWWWWWWWWWWWWWWWWWWWWWWWWWWWWWWWWWWWWW                    
WWWWWWWWWWWWWWWWWWWWWWWWWWWWWWWWWWWWWWWW                    
WWWWWWWWWWWWWWWWWWWWWWWWWWWWWWWWWWWWWWWW                    
WWWWWWWWWWWWWWWWWWWWWWWWWWWWWWWWWWWWWWWW                    
WWWWWWWWWWWWWWWWWWWWWWWWWWWWWWWWWWWWWWWW                    
WWWWWWWWWWWWWWWWWWWWWWWWWWWWWWWWWWWWWWWW                    
WWWWWWWWWWWWWWWWWWWWWWWWWWWWWWWWWWWWWWWW                    
WWWWWWWWWWWWWWWWWWWWWWWWWWWWWWWWWWWWWWWW                    
WWWWWWWWWWWWWWWWWWWWWWWWWWWWWWWWWWWWWWWW                    
WWWWWWWWWWWWWWWWWWWWWWWWWWWWWWWWWWWWWWWW                    
WWWWWWWWWWWWWWWWWWWWWWWWWWWWWWWWWWWWWWWW                    
WWWWWWWWWWWWWWWWWWWWWWWWWWWWWWWWWWWWWWWW                    
WWWWWWWWWWWWWWWWWWWWWWWWWWWWWWWWWWWWWWWW                    
WWWWWWWWWWWWWWWWWWWWWWWWWWWWWWWWWWWWWWWW                    
WWWWWWWWWWWWWWWWWWWWWWWWWWWWWWWWWWWWWWWW                    
WWWWWWWWWWWWWWWWWWWWWWWWWWWWWWWWWWWWWWWW                    
WWWWWWWWWWWWWWWWWWWWWWWWWWWWWWWWWWWWWWWW                    
WWWWWWWWWWWWWWWWWWWWWWWWWWWWWWWWWWWWWWWW                    
WWWWWWWWWWWWWWWWWWWWWWWWWWWWWWWWWWWWWWWW                    
WWWWWWWWWWWWWWWWWWWWWWWWWWWWWWWWWWWWWWWW                    
WWWWWWWWWWWWWWWWWWWWWWWWWWWWWWWWWWWWWWWW                    
WWWWWWWWWWWWWWWWWWWWWWWWWWWWWWWWWWWWWWWW                  WW
WWWWWWWWWWWWWWWWWWWWWWWWWWWWWWWWWWWWWWWW                  WW
